Rollover Text	Right-Click Text																						
"Note: Do not change the headings in this file, they are used to detect problems"																							
Main Menu																							
	"{새로운 게임}

새로운 게임을 시작합니다."																						
	"{게임 불러오기}

저장된 게임을 불러옵니다."																						
	"{득점판}

게임의 최고 득점자들을 살펴봅니다."																						
	"{만든 사람들}

게임을 만든 사람들을 봅니다."																						
	"{끝내기}

게임을 끝내고 윈도우로 돌아갑니다."																						
																							
New Game	New Game																						
	"{단일 시나리오}

단일 시나리오로 게임을 진행합니다."																						
	"{캠페인}

캠페인으로 게임을 진행합니다."																						
	"{멀티플레이}

멀티플레이로 단일 시나리오 게임을 진행합니다."																						
	"{연습 게임}

이 게임에 익숙해 지기 위해서 연습 게임을 진행합니다."																						
	"{되돌아감}

이전 화면으로 돌아갑니다."																						
																							
Single Scenario Selection	Single Scenario Selection																						
																							
SCENARIO_BACKGROUND 	시나리오를 선택하십시오.																						
ADVANCED_BACKGROUND 	고급 설정																						
Background for random map menu	사용자 설정과 랜덤 맵 만들기																						
SCENARIO_NAME 	시나리오 이름																						
Description Title	시나리오 브리핑 보기																						
Description text	시나리오 브리핑 보기																						
EASY 	"{난이도 쉬움}

플레이어는 풍부한 자원을 가지고 시작하며, 컴퓨터가 조종하는 상대방은 약합니다."																						
NORMAL 	"{난이도 보통}

플레이어는 어느 정도의 자원을 가지고 시작하며, 컴퓨터가 조종하는 상대방은 보통 수준입니다."																						
HARD 	"{난이도 어려움}

플레이어와 컴퓨터 상대방은 동일한 수량의 자원을 가지고 시작하며, 컴퓨터가 조종하는 상대방은 매우 강력합니다."																						
EXPERT 	"{난이도 고급}

플레이어는 자원에서 핸디캡(불리함)을 가지고 시작하며, 컴퓨터가 조종하는 상대방은 매우 강력합니다."																						
IMPOSSIBLE 	"{난이도 불가능}

플레이어는 자원을 전혀 보유하지 못한 상태로 게임을 시작하며, 컴퓨터가 조종하는 상대방은 매우 강력합니다."																						
ALLY_FLAG1 	이것이 당신의 색깔입니다.																						
ALLY_FLAG2 	이 색깔은 당신의 동맹국입니다.																						
ALLY_FLAG3 	이 색깔은 당신의 동맹국입니다.																						
ALLY_FLAG4 	이 색깔은 당신의 동맹국입니다.
ALLY_FLAG5 	이 색깔은 당신의 동맹국입니다
ALLY_FLAG6 	이 색깔은 당신의 동맹국입니다
ALLY_FLAG7 	이 색깔은 당신의 동맹국입니다
ALLY_FLAG8 	이 색깔은 당신의 동맹국입니다
ENEMY_FLAG1 	이 색깔은 당신의 적국입니다.
ENEMY_FLAG2 	이 색깔은 당신의 적국입니다.
ENEMY_FLAG3 	이 색깔은 당신의 적국입니다.
ENEMY_FLAG4 	이 색깔은 당신의 적국입니다.
ENEMY_FLAG5 	이 색깔은 당신의 적국입니다.
ENEMY_FLAG6 	이 색깔은 당신의 적국입니다.
ENEMY_FLAG7 	이 색깔은 당신의 적국입니다.
ENEMY_FLAG8 	이 색깔은 당신의 적국입니다.
SCENARIO_OPTIONS 	시나리오 목록 보이기/숨기기
ADVANCED_OPTIONS 	고급 옵션 보이기/숨기기
random map button	랜덤 맵에서 플레이 하기
CHAT_DESC 	시나리오 설명과 채팅 윈도우 열기/닫기
MAP_DIFFICULTY 	이곳은 시나리오의 전반적인 난이도롤 조절하는 곳입니다.
RATING 	지도와 플레이어 난이도 지정에 근거한 전반적인 난이도 표시
MAP_SIZE 	"지도 난이도는 쉬움, 보통, 어려움, 매우 어려움, 최악의 5단계가 있습니다."
VICTORY_CONDITION 	현재 시나리오의 승리조건
LOSS_CONDITION 	현재 시나리오의 패배조건
SMALL_FILTER 	소형 지도목록 보기
MEDIUM_FILTER 	중형 지도목록 보기
LARGE_FILTER 	대형 지도목록 보기
EXTRALARGE_FILTER 	초대형 지도목록 보기
ALL_FILTER 	모든 지도목록 보기
SCENARIO_NAME_1 	SCENARIO_NAME_1 
SCENARIO_NAME_2 	SCENARIO_NAME_2 
SCENARIO_NAME_3 	SCENARIO_NAME_3 
SCENARIO_NAME_4 	SCENARIO_NAME_4 
SCENARIO_NAME_5 	SCENARIO_NAME_5 
SCENARIO_NAME_6 	SCENARIO_NAME_6 
SCENARIO_NAME_7 	SCENARIO_NAME_7 
SCENARIO_NAME_8 	SCENARIO_NAME_8 
SCENARIO_NAME_9 	SCENARIO_NAME_9 
SCENARIO_NAME_10 	SCENARIO_NAME_10 
SCENARIO_NAME_11 	SCENARIO_NAME_11 
SCENARIO_NAME_12 	SCENARIO_NAME_12 
SCENARIO_NAME_13 	SCENARIO_NAME_13 
SCENARIO_NAME_14 	SCENARIO_NAME_14 
SCENARIO_NAME_15 	SCENARIO_NAME_15 
SCENARIO_NAME_16 	SCENARIO_NAME_16 
SCENARIO_NAME_17 	SCENARIO_NAME_17 
SCENARIO_NAME_18 	SCENARIO_NAME_18 
ENTRY_SCENARIO_NAME_1 	ENTRY_SCENARIO_NAME_1 
ENTRY_SCENARIO_NAME_2 	ENTRY_SCENARIO_NAME_2 
ENTRY_SCENARIO_NAME_3 	ENTRY_SCENARIO_NAME_3 
ENTRY_SCENARIO_NAME_4 	ENTRY_SCENARIO_NAME_4 
ENTRY_SCENARIO_NAME_5 	ENTRY_SCENARIO_NAME_5 
ENTRY_SCENARIO_NAME_6 	ENTRY_SCENARIO_NAME_6 
ENTRY_SCENARIO_NAME_7 	ENTRY_SCENARIO_NAME_7 
ENTRY_SCENARIO_NAME_8 	ENTRY_SCENARIO_NAME_8 
ENTRY_SCENARIO_NAME_9 	ENTRY_SCENARIO_NAME_9 
ENTRY_SCENARIO_NAME_10 	ENTRY_SCENARIO_NAME_10 
ENTRY_SCENARIO_NAME_11 	ENTRY_SCENARIO_NAME_11 
ENTRY_SCENARIO_NAME_12 	ENTRY_SCENARIO_NAME_12 
ENTRY_SCENARIO_NAME_13 	ENTRY_SCENARIO_NAME_13 
ENTRY_SCENARIO_NAME_14 	ENTRY_SCENARIO_NAME_14 
ENTRY_SCENARIO_NAME_15 	ENTRY_SCENARIO_NAME_15 
ENTRY_SCENARIO_NAME_16 	ENTRY_SCENARIO_NAME_16 
ENTRY_SCENARIO_NAME_17 	ENTRY_SCENARIO_NAME_17 
ENTRY_SCENARIO_NAME_18 	ENTRY_SCENARIO_NAME_18 
TURN_DURATION 	턴(차례) 경과시간
CHAT_TEXT 	대화 메시지						
CHAT_ENTRY 	CHAT_ENTRY 						
CHAT_PLUG 	CHAT_PLUG 						
CHAT_PLAYER 	플레이어						
"CHAT_PLAYER_SLIDER,"	"CHAT_PLAYER_SLIDER,"						
ROLLOVER 	ROLLOVER 						
NEXT 	현재 선택된 게임 저장						
BEGIN 	선택한 시나리오 시작						
BACK 	BACK 						
SSEXIT 	"이 윈도우를 닫음
(어떤 행동도 없음)"						
WHICHMAP 	"현재 지도 크기
(소형, 중형, 대형, 초대형)"						
SORT_NUMBER 	플레이어 숫자에 따른 지도 분류						
SORT_SIZE 	크기에 따른 지도 분류						
k_sort_version	버전에 따른 지도 분류						
SORT_ALPHA 	알파벳 순서에 따른 지도 분류						
SORT_VICTORY 	승리 조건에 따른 지도 분류						
SORT_LOSS 	패배 조건에 따른 지도 분류
BRIEFING 	BRIEFING 
SSHERO 	SSHERO 
GOLDPIC 	GOLDPIC 
HUMAN_CPU1 	인간 혹은 CPU 라는 것은 이 색깔이 인간이나 컴퓨터 플레이어에게 모두 선택될 수 있다는 것을 의미합니다. CPU 라는 것은 컴퓨터 플레이어만이 이 색깔을 선택할 수 있다는 것을 의미합니다.
HUMAN_CPU2 	인간 혹은 CPU 라는 것은 이 색깔이 인간이나 컴퓨터 플레이어에게 모두 선택될 수 있다는 것을 의미합니다. CPU 라는 것은 컴퓨터 플레이어만이 이 색깔을 선택할 수 있다는 것을 의미합니다.
HUMAN_CPU3 	인간 혹은 CPU 라는 것은 이 색깔이 인간이나 컴퓨터 플레이어에게 모두 선택될 수 있다는 것을 의미합니다. CPU 라는 것은 컴퓨터 플레이어만이 이 색깔을 선택할 수 있다는 것을 의미합니다.
HUMAN_CPU4 	인간 혹은 CPU 라는 것은 이 색깔이 인간이나 컴퓨터 플레이어에게 모두 선택될 수 있다는 것을 의미합니다. CPU 라는 것은 컴퓨터 플레이어만이 이 색깔을 선택할 수 있다는 것을 의미합니다.
HUMAN_CPU5 	인간 혹은 CPU 라는 것은 이 색깔이 인간이나 컴퓨터 플레이어에게 모두 선택될 수 있다는 것을 의미합니다.  CPU 라는 것은 컴퓨터 플레이어만이 이 색깔을 선택할 수 있다는 것을 의미합니다.
HUMAN_CPU6 	인간 혹은 CPU 라는 것은 이 색깔이 인간이나 컴퓨터 플레이어에게 모두 선택될 수 있다는 것을 의미합니다.  CPU 라는 것은 컴퓨터 플레이어만이 이 색깔을 선택할 수 있다는 것을 의미합니다.
HUMAN_CPU7 	인간 혹은 CPU 라는 것은 이 색깔이 인간이나 컴퓨터 플레이어에게 모두 선택될 수 있다는 것을 의미합니다.  CPU 라는 것은 컴퓨터 플레이어만이 이 색깔을 선택할 수 있다는 것을 의미합니다.
HUMAN_CPU8 	인간 혹은 CPU 라는 것은 이 색깔이 인간이나 컴퓨터 플레이어에게 모두 선택될 수 있다는 것을 의미합니다.  CPU 라는 것은 컴퓨터 플레이어만이 이 색깔을 선택할 수 있다는 것을 의미합니다.
HANDICAP1 	시작시의 자원을 삭감함으로서 이 플레이에게 핸디캡을 부여합니다.
HANDICAP2 	시작시의 자원을 삭감함으로서 이 플레이에게 핸디캡을 부여합니다.
HANDICAP3 	시작시의 자원을 삭감함으로서 이 플레이에게 핸디캡을 부여합니다.
HANDICAP4 	시작시의 자원을 삭감함으로서 이 플레이에게 핸디캡을 부여합니다.
HANDICAP5 	시작시의 자원을 삭감함으로서 이 플레이에게 핸디캡을 부여합니다.
HANDICAP6 	시작시의 자원을 삭감함으로서 이 플레이에게 핸디캡을 부여합니다.
HANDICAP7 	시작시의 자원을 삭감함으로서 이 플레이에게 핸디캡을 부여합니다.
HANDICAP8 	시작시의 자원을 삭감함으로서 이 플레이에게 핸디캡을 부여합니다.
TOWN_LEFT1 	시작하는 마을의 종류를 선택합니다.
TOWN_LEFT2 	시작하는 마을의 종류를 선택합니다.
TOWN_LEFT3 	시작하는 마을의 종류를 선택합니다.
TOWN_LEFT4 	시작하는 마을의 종류를 선택합니다.
TOWN_LEFT5 	시작하는 마을의 종류를 선택합니다.
TOWN_LEFT6 	시작하는 마을의 종류를 선택합니다.
TOWN_LEFT7 	시작하는 마을의 종류를 선택합니다.
TOWN_LEFT8 	시작하는 마을의 종류를 선택합니다.
TOWN_RITE1 	시작하는 마을의 종류를 선택합니다.
TOWN_RITE2 	시작하는 마을의 종류를 선택합니다.
TOWN_RITE3 	시작하는 마을의 종류를 선택합니다.
TOWN_RITE4 	시작하는 마을의 종류를 선택합니다.
TOWN_RITE5 	시작하는 마을의 종류를 선택합니다.
TOWN_RITE6 	시작하는 마을의 종류를 선택합니다.
TOWN_RITE7 	시작하는 마을의 종류를 선택합니다.
TOWN_RITE8 	시작하는 마을의 종류를 선택합니다.
HERO_LEFT1 	마을의 종류에 따라 시작하는 영웅을 선택합니다.
HERO_LEFT2 	마을의 종류에 따라 시작하는 영웅을 선택합니다.
HERO_LEFT3 	마을의 종류에 따라 시작하는 영웅을 선택합니다.
HERO_LEFT4 	마을의 종류에 따라 시작하는 영웅을 선택합니다.
HERO_LEFT5 	마을의 종류에 따라 시작하는 영웅을 선택합니다.
HERO_LEFT6 	마을의 종류에 따라 시작하는 영웅을 선택합니다.
HERO_LEFT7 	마을의 종류에 따라 시작하는 영웅을 선택합니다.
HERO_LEFT8 	마을의 종류에 따라 시작하는 영웅을 선택합니다.
HERO_RITE1 	마을의 종류에 따라 시작하는 영웅을 선택합니다.
HERO_RITE2 	마을의 종류에 따라 시작하는 영웅을 선택합니다.
HERO_RITE3 	마을의 종류에 따라 시작하는 영웅을 선택합니다.
HERO_RITE4 	마을의 종류에 따라 시작하는 영웅을 선택합니다.
HERO_RITE5 	마을의 종류에 따라 시작하는 영웅을 선택합니다.
HERO_RITE6 	마을의 종류에 따라 시작하는 영웅을 선택합니다.
HERO_RITE7 	마을의 종류에 따라 시작하는 영웅을 선택합니다.
HERO_RITE8 	마을의 종류에 따라 시작하는 영웅을 선택합니다.
RES_LEFT1 	시작하는 영웅의 보너스를 선택합니다.
RES_LEFT2 	시작하는 영웅의 보너스를 선택합니다.
RES_LEFT3 	시작하는 영웅의 보너스를 선택합니다.
RES_LEFT4 	시작하는 영웅의 보너스를 선택합니다.
RES_LEFT5 	시작하는 영웅의 보너스를 선택합니다.
RES_LEFT6 	시작하는 영웅의 보너스를 선택합니다.
RES_LEFT7 	시작하는 영웅의 보너스를 선택합니다.
RES_LEFT8 	시작하는 영웅의 보너스를 선택합니다.
RES_RITE1 	시작하는 영웅의 보너스를 선택합니다.
RES_RITE2 	시작하는 영웅의 보너스를 선택합니다.
RES_RITE3 	시작하는 영웅의 보너스를 선택합니다.
RES_RITE4 	시작하는 영웅의 보너스를 선택합니다.
RES_RITE5 	시작하는 영웅의 보너스를 선택합니다.
RES_RITE6 	시작하는 영웅의 보너스를 선택합니다.
RES_RITE7 	시작하는 영웅의 보너스를 선택합니다.
RES_RITE8 	시작하는 영웅의 보너스를 선택합니다.
HERO_SETTING_1 	이 색깔로 플레이 하려면 여기에 클릭하세요.
HERO_SETTING_2 	이 색깔로 플레이 하려면 여기에 클릭하세요.
HERO_SETTING_3 	이 색깔로 플레이 하려면 여기에 클릭하세요.
HERO_SETTING_4 	이 색깔로 플레이 하려면 여기에 클릭하세요.
HERO_SETTING_5 	이 색깔로 플레이 하려면 여기에 클릭하세요.
HERO_SETTING_6 	이 색깔로 플레이 하려면 여기에 클릭하세요.
HERO_SETTING_7 	이 색깔로 플레이 하려면 여기에 클릭하세요.
HERO_SETTING_8 	이 색깔로 플레이 하려면 여기에 클릭하세요.
TOWN_SETTING_1 	TOWN_SETTING_1 
TOWN_SETTING_2 	TOWN_SETTING_2 
TOWN_SETTING_3 	TOWN_SETTING_3 
TOWN_SETTING_4 	TOWN_SETTING_4 
TOWN_SETTING_5 	TOWN_SETTING_5 	
TOWN_SETTING_6 	TOWN_SETTING_6 	
TOWN_SETTING_7 	TOWN_SETTING_7 	
TOWN_SETTING_8 	TOWN_SETTING_8 	
"const_create_map,"		
"const_map_size_label,"	맵 크기 선택	
"const_small_map,"	small 맵 만들기	
"const_medium_map,"	medium 맵 만들기	
"const_large_map,"	large 맵 만들기	
"const_huge_map,"	huge 맵 만들기	
"const_map_levels,"	싱글 또는 2층 맵 선택	
"const_human_positions_label,"	사용자가 플레이할 수 있는 위치 개수 선택	
"const_1_human,"	1 사용자 플레이어	
"const_2_humans,"	 2 사용자 플레이어	
"const_3_humans,"	3 사용자 플레이어	
"const_4_humans,"	 4 사용자 플레이어	
"const_5_humans,"	5 사용자 플레이어	
"const_6_humans,"	6 사용자 플레이어	
"const_7_humans,"	7 사용자 플레이어	
"const_8_humans,"	8 사용자 플레이어	
"const_random_humans,"	1-8 사용자 플레이어 만들기	
"const_human_teams_label,"	사용자 팀이 플레이할 수 있는 위치 개수 선택	
"const_no_human_teams,"	팀 없음	
"const_1_human_team,"	1 사용자 팀 만들기	
"const_2_human_teams,"	2 사용자 팀 만들기	
"const_3_human_teams,"	3 사용자 팀 만들기	
"const_4_human_teams,"	4 사용자 팀 만들기	
"const_5_human_teams,"	5 사용자 팀 만들기	
"const_6_human_teams,"	6 사용자 팀 만들기	
"const_7_human_teams,"	7 사용자 팀 만들기	
"const_random_human_teams,"	사용자 팀 개수를 랜덤으로 만들기	
"const_computer_positions_label,"	컴퓨터 시작위치 개수 선택	
"const_no_computers,"	컴퓨터 플레이어 없음	
"const_1_computer,"	1 컴퓨터 플레이어 위치	
"const_2_computers,"	2 컴퓨터 플레이어 위치	
"const_3_computers,"	3 컴퓨터 플레이어 위치	
"const_4_computers,"	4 컴퓨터 플레이어 위치	
"const_5_computers,"	5 컴퓨터 플레이어 위치	
"const_6_computers,"	6 컴퓨터 플레이어 위치	
"const_7_computers,"	7 컴퓨터 플레이어 위치	
"const_random_computers,"	컴퓨터 위치 개수를 랜덤으로 만들기	
"const_computer_teams_label,"	컴퓨터 팀의 개수 선택	
"const_no_computer_teams,"	컴퓨터 팀 없음	
"const_1_computer_team,"	1 컴퓨터 팀	
"const_2_computer_teams,"	2 컴퓨터 팀	
"const_3_computer_teams,"	3 컴퓨터 팀	
"const_4_computer_teams,"	4 컴퓨터 팀	
"const_5_computer_teams,"	5 컴퓨터 팀	
"const_6_computer_teams,"	6 컴퓨터 팀	
"const_random_computer_teams,"	컴퓨터 팀 개수를 랜덤으로 만들기	
"const_water_label,"	지도상의 바다 면적 선택	
"const_no_water,"	최소 또는 없음	
"const_normal_water,"	바다로 둘러싸인 대륙	
"const_islands,"	많은 섬들로 이루어진 지형	
"const_random_water,"	바다 면적을 랜덤으로 하기	
"const_monster_strength_label,"	몬스터의 강약 선택	
"const_weak_monsters,"	보통보다 약함	
"const_normal_monsters,"	보통	
"const_strong_monsters,"	강함	
"const_random_monsters,"	강약을 랜덤으로 선택	
"const_show_saved_random_maps,"	최근에 만든 랜덤 맵 보기	
SLIDER_CHATWINDOW 	채팅 텍스트 살펴보기	
SLIDER_FILEMENU 	시나리오나 저장된 게임 목록 살펴보기	
SLIDER_DURATION 	플레이어 턴(차례)의 지속시간을 결정합니다.	
"PLAYER_HANDICAP_HEADER_ID,"	"{플레이어 이름 / 핸디캡 종류}

인간 플레이어가 사용가능한 빈칸은 근처의 배너로 표시되어 있습니다. 배너에 클릭하면 플레이어의 위치가 변경됩니다.  이름 란 클릭하면 플레이어의 이름을 변경할 수 있습니다.

각각의 플레이어는 핸디캡 버튼을 누르면 핸디캡을 부여 받습니다. 핸디캡 조건은 세가지가 있습니다: 핸디캡 없음, 가벼운 핸디캡, 무거운 핸디캡.  가벼운 핸디캡이나 무거운 핸디캡 모두 게임의 시작시에 플레이어의 자원을 감소시키게 됩니다.
"																						
"TURN_DURATION_HEADER_ID,"	"{플레이어 턴 지속시간}

슬라이더를 이용하여, 당신은 플레이어 턴 지속시간을 '유연' 하게 지정할 수 있습니다. 이러한 경우, 전투가 벌어질 때는 시간이 경과하지 않으며, 그 이외의 경우에 시간이 흘러가게 됩니다. 

지정 가능한 시간값은 1, 2, 4, 6, 8, 10, 15, 20, 25, 30 분입니다.
초기 설정은 '무제한' 으로 되어 있습니다.
"																						
"STARTING_TOWN_HEADER_ID,"	"{시작 마을}

각각의 플레이어는 마을을 보유한 채로 게임을 시작할 수도 있습니다.  선택 가능한 값은 다음과 같습니다. 랜덤으 도시, 성 도시, 자연 도시, 타워 도시, 지옥 도시, 네크로폴리스 도시, 던젼 도시, 스트롱홀드 도시, 요새 도시.

만약 당신이 마을을 보유하지 않은 채로 게임을 시작한다면, 이 설정들은 가능한 영웅들을 선택하는 데 도움을 주는 방향으로 사용될 수 있습니다.
"																						
"STARTING_TOWN_HEADER_W_CONFLUX_ID,"	"{시작 마을}

각각의 플레이어는 시작 마을을 가질 수도, 가지지 않을 수도 있습니다. 캐슬, 램파트, 타워, 인페르노, 네크로폴리스, 던젼, 스트롱홀드, 포트리스, 컨플럭스, 또는 랜덤으로도 할 수 있습니다.

시작 마을이 없을 때에는, 이 설정들이 가능한 시작 영웅의 조합을 결정하는 데 쓰여질 수도 있습니다.
"																						
"STARTING_HERO_HEADER_ID,"	"{시작 영웅}

각각의 플레이어는 영웅들을 보유한 상태로 게임을 시작할 수도 있습니다.  종종 이 옵션은 고정되어 변경이 불가능한 경우도 있습니다.  그런 경우가 아니라면 당신은 16가지 유형의 영웅들을 살펴볼 수 있습니다.  시작 마을 옵션이 가동중이라면, 마을의 종류를 변경하여 선택 가능한 영웅들의 종류를 변경할 수 있습니다.

영웅의 이름, 종류, 특수 능력을 보려면 영웅의 사진을 우클릭하면 됩니다.
"																						
"STARTING_BONUS_HEADER_ID,"	"{시작 보너스}

이 항목에서, 당신은 랜덤 아티팩트, 500-1000 금, 혹은  5-10단위 목재와 철광석을 선택할 수 있습니다.
"																						
																							
Multiplayer Selection	Multiplayer Selection																						
																							
온라인 서비스	"{온라인 서비스}

온라인 서비스를 이용하여 게임을 즐길 수 있습니다."																						
핫 시트	"{핫 시트}

1대의 컴퓨터로 여러 사람이 각기 다른 플레이어를 선택하여 돌아가면서 게임을 진행합니다."																						
IPX	"{IPX}

LAN을 이용하여 멀티플레이를 즐깁니다."																						
TCP/IP	"{TCP/IP}

LAN이나 인터넷을 이용하여 멀티플레이를 즐깁니다."																						
모뎀	"{모뎀}

두명의 플레이어가 모뎀을 통해 멀티플레이를 즐깁니다."																						
직접 연결	"{직접 연결}

두명의 플레이어가 시리얼 케이블 연결을 통해 멀티플레이를 즐깁니다."																						
게임 주최	"{게임 주최}

게임을 설정하고 지도를 채택하여 멀티플레이 게임을 주최하고, 다른 사람들은 참여합니다."																						
게임 참여	"{게임 참여}

참여 가능한 멀티플레이 게임을 보여준다."
게임 검색	"{게임 검색}

연결을 위해 특정한 IP 주소로 들어갑니다."
GAMENAME 1	GAMENAME 1
GAMENAME 2	GAMENAME 2
GAMENAME 3	GAMENAME 3
GAMENAME 4	GAMENAME 4
GAMENAME 5	GAMENAME 5
GAMENAME 6	GAMENAME 6
GAMENAME 7	GAMENAME 7
GAMENAME 8	GAMENAME 8
GAMENAME 9	GAMENAME 9
GAMENAME 10	GAMENAME 10
GAMENAME 11	GAMENAME 11
GAMENAME 12	GAMENAME 12
가능한 게임 살펴보기	참여 가능한 게임을 살펴봅니다.
	
취소	이전 메뉴로 되돌아갑니다.																						
																							
Adventure Map Window																							
세계 지도	"전 세계의 축소판을 보여줍니다.  특정 지점에 클릭하면 모험 지도가 그 지점을 중심으로 잡게 되며, 외곽선 박스를 끌어당기면 모험 지도를 두루 살펴볼 수도 있습니다."																						
상태 윈도우	SELECTION WINDOW																						
왕국 개괄	"{왕국 개괄}

당신의 마을과 영웅들에 대해서 살펴봅니다."																						
지상/지하세계 보기	"{지상/지하세계 보기}

모험 지도에서 지상이나 지하세계를 바꿔가면서 볼 수 있습니다."																						
모험 기록	"{모험 기록}

현재 모험에 대한 목록이 표시됩니다."																						
영웅 휴식/활동	"{영웅 휴식/활동}

활동중인 영웅을 쉬게 하거나 휴식중인 영웅을 활동하게 합니다.  휴식중인 영웅은 다음 영웅 버튼에서 무시됩니다."																						
영웅 이동	"{영웅 이동}

선택한 영웅을 지정한 경로로 이동시킵니다."																						
마법 주문 사용	"{마법 주문 사용}

비-전투 마법 주문을 사용합니다."																						
모험 옵션	"{모험 옵션}

땅을 파서 숨겨진 성궤를 찾거나, 성궤의 위치가 새겨진 퍼즐을 보거나, 세계 지도나 시나리오 브리핑을 살펴볼 수 있습니다. 멀티플레이 게임에서 당신은 상대방의 마지막 턴을 볼 수 있습니다."																						
시스템 옵션	"{시스템 옵션}

현재 게임 옵션을 살펴보거나 변경합니다."																						
다음 영웅	"{다음 영웅}

이동력이 남아있는 다음 영웅을 선택합니다.  단, 휴식중인 영웅은 무시합니다."																						
턴 끝내기	"{턴 끝내기}

현재 턴을 종료하고 다음 턴으로 넘어갑니다."																						
영웅 목록 살펴보기	"{영웅 목록 살펴보기}

현재 활동중인 영웅들의 목록을 봅니다."																						
영웅 목록 살펴보기	"{영웅 목록 살펴보기}

현재 활동중인 영웅들의 목록을 봅니다."																						
영웅 사진	"{영웅 사진}

한번 클릭하면 해당 영웅이 선택되고, 지도는 그의 위치를 중심으로 잡습니다. 다시 한번 클릭하면 해당 영웅의 정보를 보여주는 영웅 화면으로 들어갑니다."																						
마을 목록 살펴보기	"{마을 목록 살펴보기}

현재 존재하는 마을의 목록을 봅니다."																						
마을 목록 살펴보기	"{마을 목록 살펴보기}

현재 존재하는 마을의 목록을 봅니다."																						
마을 그림	"{마을 그림}

한번 클릭하면 해당 마을이 선택되며, 모험 지도는 마을을 중심으로 잡습니다.  다시 한번 클릭하면 마을의 정보를 보여주는 마을 화면으로 들어갑니다."																						
금	당신이 소유한 금의 수량																						
목재	당신이 소유한 목재 수량																						
수은	당신이 소유한 수은 수량																						
철광석	당신이 소유한 철광석 수량																						
유황	당신이 소유한 유황 수량																						
수정	당신이 소유한 수정 수량																						
보석	당신이 소유한 보석 수량																						
날짜	"{날짜}

달, 주, 그리고 날짜를 표시합니다."																						
ROLLOVER	ROLLOVER																						
																							
System Options	System Options																						
주메뉴	"{주메뉴}

게임을 포기하고 주메뉴로 이동합니다."
게임 불러오기	"{게임 불러오기}

저장된 게임을 불러옵니다."
게임 저장하기	"{게임 저장하기}

현재 진행중인 게임을 저장합니다."
시나리오 재시작	"{시나리오 재시작}

현재 시나리오를 처음부터 다시 시작합니다."
게임 종료하기	"{게임 종료하기}

게임을 종료하고 윈도우로 나갑니다."
되돌아가기	"{게임으로 되돌아가기}

모험 지도로 되돌아갑니다!"
"MUSIC_VOLUME_0_ID,"	배경음악 끄기
"MUSIC_VOLUME_1_ID,"	배경음악 볼륨 1
"MUSIC_VOLUME_2_ID,"	배경음악 볼륨 2
"MUSIC_VOLUME_3_ID,"	배경음악 볼륨 3
"MUSIC_VOLUME_4_ID,"	배경음악 볼륨 4
"MUSIC_VOLUME_5_ID,"	배경음악 볼륨 5
"MUSIC_VOLUME_6_ID,"	배경음악 볼륨 6
"MUSIC_VOLUME_7_ID,"	배경음악 볼륨 7
"MUSIC_VOLUME_8_ID,"	배경음악 볼륨 8
"MUSIC_VOLUME_9_ID,"	배경음악 볼륨 9
"EFFECTS_VOLUME_0_ID,"	음향효과 끄기
"EFFECTS_VOLUME_1_ID,"	음향효과 볼륨 1
"EFFECTS_VOLUME_2_ID,"	음향효과 볼륨 2
"EFFECTS_VOLUME_3_ID,"	음향효과 볼륨 3
"EFFECTS_VOLUME_4_ID,"	음향효과 볼륨 4
"EFFECTS_VOLUME_5_ID,"	음향효과 볼륨 5
"EFFECTS_VOLUME_6_ID,"	음향효과 볼륨 6
"EFFECTS_VOLUME_7_ID,"	음향효과 볼륨 7
"EFFECTS_VOLUME_8_ID,"	음향효과 볼륨 8
"EFFECTS_VOLUME_9_ID,"	음향효과 볼륨 9
"MUSIC_TYPE_NONE_ID,"	"MUSIC_TYPE_NONE_ID,"
"MUSIC_TYPE_CD_ID,"	"MUSIC_TYPE_CD_ID,"
"MUSIC_TYPE_MIDI_ID,"	"MUSIC_TYPE_MIDI_ID,"
"HERO_SPEED_WALK_ID,"	영웅 속도 매우 느리게 지정
"HERO_SPEED_CANTER_ID,"	영웅 속도 느리게 지정
"HERO_SPEED_GALLOP_ID,"	영웅 속도 빠르게 지정
"HERO_SPEED_JUMP_ID,"	영웅 속도 매우 빠르게 지정 (이동과정이 보이지 않음)
"AI_SPEED_CANTER_ID,"	적 영웅 속도 느리게 지정
"AI_SPEED_GALLOP_ID,"	적 영웅 속도 빠르게 지정
"AI_SPEED_JUMP_ID,"	"적 영웅 속도 매우 빠르게 지정 (이동과정이 보이지 않음)"
"AI_SPEED_NONE_ID,"	적 영웅의 움직임이 보이지 않음
"WINDOW_SCROLL_SLOW,"	지도 스크롤 속도 느리게 지정
"WINDOW_SCROLL_MEDIUM,"	지도 스크롤 속도 보통으로 지정
"WINDOW_SCROLL_FAST,"	지도 스크롤 속도 빠르게 지정
"SHOW_PATH_ID,"	"{이동 경로 표시}

여기에 표시하면 영웅의 이동전 미리 지정된 경로가 표시됩니다."
"MOVE_REMINDER_ID,"	"{이동 경로 기억}

플레이어의 영웅 중에서 이동력이 남아 있을때 턴을 종료하면, 이를 다시 한번 상기시켜 줍니다."
"QUICK_COMBAT_ID,"	"{빠른 전투}

전투과정은 표시되지 않고, 컴퓨터의 의해 계산된 전투의 결과가 즉시 표시됩니다."
"VIDEO_SUBTITLES_ID,"	"{비디오 자막}

비주얼이 나올때 자막이 표시되는지를 지정합니다."
VIDEO_QUALITY_LOW	"{저화질}

화면을 풀스크린으로 실행하기에는 무리가 있는 저사양 컴퓨터를 위한 지정입니다."
VIDEO_QUALITY_HIGH	"{고화질}

컴퓨터의 능력이 허용하는 범위내에서 최고 화질의 그래픽을 볼 수 있으며, 고사양 컴퓨터를 위한 지정입니다."
"TOWN_OUTLINES_ID,"	"{건물 외형선}

마을 화면에서 커서가 건물에 위치하면 노란색의 외형선을 표시할 것인지를 지정합니다."
"ANIMATE_SPELLBOOK_ID,"	"{마법 책 애니메이션}

마법 책에서 페이지를 넘길때 애니메이션 효과를 지정합니다."
																							
Adventure Options																							
세계 보기	"{세계 보기}

전체 지도를 조망합니다."																						
퍼즐 보기	"{퍼즐 보기}

땅에 묻힌 보물의 위치를 보여주는 보물지도를 봅니다."																						
시나리오 정보 보기	"{시나리오 정보 보기}

현재 시나리오에 대한 정보를 살펴봅니다."																						
땅파기	"{땅파기}

땅에 묻힌 성궤를 파냅니다."																						
상대방 턴 재연	"{상대방 턴 재연}

이전 상대방 턴에서 발생한 일들을 살펴봅니다."																						
ROLLOVER	ROLLOVER																						
승인	"{승인}

모험 지도로 돌아갑니다."																						
																							
Combat Window	Combat Window																						
항복	"{항복}

적에게 항복하는 것으로서, 일정액의 금을 지불해야만 합니다. 일단 항복한 영웅은 소지 물체와 부대를 그대로 가진 상태로 곧바로 마을의 선술집에서 다시 고용할 수 있습니다."																						
퇴각	"{퇴각}

당신의 영웅은 전투에서 퇴각합니다. 퇴각한 영웅은 소지한 물체를 그대로 간직한 채로 마을의 선술집에서 고용할 수 있습니다."																						
전투 옵션	"{전투 옵션}

현재 전투 옵션 설정을 살펴보고, 이를 변경합니다."																						
자동 전투	"{자동 전투}

컴퓨터가 당신 대신 전투를 지휘합니다.  자동 전투중 당신이 직접 전투를 지휘하려면 어느 곳에나 클릭하면 됩니다. 다음 부대 부터 당신이 지휘하게 됩니다."																						
	전투 텍스트가 이곳에 표시됩니다.																						
	전투중 표시된 텍스트 목록을 봅니다.																						
마법 주문 사용	"{마법 주문 사용}

당신의 영웅이 소지한 마법 책을 펼쳐서 마법 주문을 사용합니다."																						
대기	"{대기}

해당 부대를 다음 차례까지 제자리에 대기시킵니다."																						
방어	"{방어}

해당 차례에서 움직이지 않는 대신 해당 부대의 방어력을 증가시킵니다."																						
페이즈 대기	페이즈 대기																						
전술 페이즈 종료	"{전술 페이즈 종료}

부대 배치 페이즈를 종료하고 전투를 시작합니다."																						
																							
Combat Options	Combat Options																						
게임으로 돌아가기	"{게임으로 돌아가기}

전투 옵션을 빠져나갑니다."																						
초기 설정값 복원	"{초기 설정값}

전투 옵션의 초기 설정값을 복원합니다."																						
"MUSIC_VOLUME_0_ID,"	배경음악 끄기																						
"MUSIC_VOLUME_1_ID,"	배경음악 볼륨 1																						
"MUSIC_VOLUME_2_ID,"	배경음악 볼륨 2																						
"MUSIC_VOLUME_3_ID,"	배경음악 볼륨 3																						
"MUSIC_VOLUME_4_ID,"	배경음악 볼륨 4																						
"MUSIC_VOLUME_5_ID,"	배경음악 볼륨 5																						
"MUSIC_VOLUME_6_ID,"	배경음악 볼륨 6
"MUSIC_VOLUME_7_ID,"	배경음악 볼륨 7
"MUSIC_VOLUME_8_ID,"	배경음악 볼륨 8
"MUSIC_VOLUME_9_ID,"	배경음악 볼륨 9
"EFFECTS_VOLUME_0_ID,"	음향효과 끄기
"EFFECTS_VOLUME_1_ID,"	음향효과 볼륨 1
"EFFECTS_VOLUME_2_ID,"	음향효과 볼륨 2
"EFFECTS_VOLUME_3_ID,"	음향효과 볼륨 3
"EFFECTS_VOLUME_4_ID,"	음향효과 볼륨 4
"EFFECTS_VOLUME_5_ID,"	음향효과 볼륨 5
"EFFECTS_VOLUME_6_ID,"	음향효과 볼륨 6
"EFFECTS_VOLUME_7_ID,"	음향효과 볼륨 7
"EFFECTS_VOLUME_8_ID,"	음향효과 볼륨 8
"EFFECTS_VOLUME_9_ID,"	음향효과 볼륨 9
"MUSIC_TYPE_NONE_ID,"	"MUSIC_TYPE_NONE_ID,"
"MUSIC_TYPE_CD_ID,"	"MUSIC_TYPE_CD_ID,"
"MUSIC_TYPE_MIDI_ID,"	"MUSIC_TYPE_MIDI_ID,"
"AUTO_CREATURES_ID,"	"{괴물}

괴물들의 지휘를 자동 전투로 넘겨줍니다."
"AUTO_SPELLS_ID,"	"{마법 주문}

자동 전투중에 영웅이 마법 주문을 사용합니다."
"AUTO_CATAPULT_ID,"	"{투석기}

공성전에서 당신의 투석기는 어느 성벽을 타격할지 스스로 결정합니다. 만약 당신 영웅의 발사술 등급이 충분히 높은 수준이라면, 투석기를 직접 조종할 수 있습니다.

만약 당신의 영웅이 발사술 능력을 보유한 상태에서 이 옵션을 선택하면, 전투중 투석기의 지휘를 컴퓨터로 넘겨줍니다."
"AUTO_BALLISTA_ID,"	"{쇠뇌}

전투중, 당신의 쇠뇌는 어느 적군 부대를 공격할지 스스로 결정합니다. 만약 당신 영웅의 포술 등급이 충분히 높은 수준이라면, 쇠뇌를 직접 조종할 수 있습니다.

만약 당신의 영웅이 포술 능력을 보유한 상태에서 이 옵션을 선택하면, 전투중 쇠뇌의 지휘를 하게됩니다."
"AUTO_FIRST_AID_TENT_ID,"	"{구급 텐트}

전투중, 당신의 구급 텐트는 어느 아군 부대를 치료할지 스스로 결정합니다. 만약 당신 영웅의 응급 치료 등급이 충분히 높은 수준이라면, 구급 텐트를 직접 조종할 수 있습니다.

만약 당신의 영웅이 응급 치료 등력을 보유한 상태에서 이 옵션을 선택하면, 전투중 구급 텐트의 지휘를 컴퓨터로 넘겨줍니다."
"ANIMATION_SPEED_0_ID,"	애니메이션 속도 느림
"ANIMATION_SPEED_1_ID,"	애니메이션 속도 보통
"ANIMATION_SPEED_2_ID,"	애니메이션 속도 빠름
"CREATURE_INFO_STATS_ID,"	"{모든 정보}

특정 부대에 우클릭하면 현재 영향을 미치고 있는 마법을 포함하여 해당 부대에 대한 모든 정보를 볼 수 있습니다."
"CREATURE_INFO_SPELLS_ID,"	"{마법만}

특정 부대에 우클릭하면 현재 해당 부대에 영향을 미치고 있는 마법만을 볼 수 있습니다."
"VIEW_HEX_ID,"	"{헥스 경계선 표시}

전장에서 헥스(칸)의 경계선을 표시해 줍니다."
"MOVEMENT_SHADOW_ID,"	"{이동범위 그림자}

현재 선택한 부대가 이동할 수 있는 범위가 어두운 색으로 표시됩니다."
"SHADOW_CURSOR_ID,"	"{커서 그림자}

현재 커서가 위치한 지역이 어두운 색으로 표시됩니다."
"ANIMATE_SPELLBOOK_ID,"	"{마법책 애니메이션}

마법 책의 페이지를 넘길때 애니메이션이 표시됩니다."
	
View Army	View Army																						
괴물 이름	괴물 이름																						
숫자	부대에 배속된 괴물의 숫자																						
공격력	공격력																						
방어력	방어력																						
남은 발사횟수	남은 발사횟수																						
1회 공격당 피해량	1회 공격당 피해량																						
생명력	생명력																						
남은 생명력	남은 생명력																						
이동속도	이동속도																						
사기	사기																						
행운	행운																						
현재 영향을 미치고 있는 마법	현재 영향을 미치고 있는 마법																						
해고	"{부대 해고}

당신의 군대에서 해당 부대를 해고합니다."																						
업그레이드	"{부대 업그레이드}

현재 선택된 부대를 업그레이드 합니다."																						
승인	"{승인}

이전 윈도우로 돌아갑니다."																						
																							
Spell Book	Spell Book																						
이전 페이지	이전 페이지																						
다음 페이지	다음 페이지																						
모험 마법	마법 책에 적힌 모험 마법을 표시합니다.																						
전투 마법	마법 책에 적힌 전투 마법을 표시합니다.																						
공기마법	마법 책에 적힌 대기마법을 표시합니다.																						
불마법	마법 책에 적힌 불마법을 표시합니다.																						
물마법	마법 책에 적힌 물마법을 표시합니다.																						
땅마법	마법 책에 적힌 땅마법을 표시합니다.																						
모든 마법	마법 책에 적힌 모든 계열의 마법을 표시합니다.																						
마법 점수	영웅에게 남아 있는 마법 점수																						
나가기	마법책을 덮습니다.																						
																							
CampaignBrief	CampaignBrief																						
																							
CAMPAIGN_NAME	CAMPAIGN_NAME
CAMPAIGN_DESCRIPTION	CAMPAIGN_DESCRIPTION
MAP_NAME	MAP_NAME
MAP_DESCRIPTION	MAP_DESCRIPTION
HERO_FACE	HERO_FACE
영웅 교체	당신의 시작하는 영웅을 변경하려면 이곳에 클릭하세요.
영웅 교체	당신의 시작하는 영웅을 변경하려면 이곳에 클릭하세요.
물체 보너스	물체를 소지하고 시작
금 보너스	금을 더 많이 보유하고 시작
자원 보너스	자원을 더 많이 보유하고 시작
다시 시작	"{다시 시작}

현재 캠페인을 다시 시작합니다."
캠페인 소개 보기	"{캠페인 소개 보기}

캠페인을 소개하는 비쥬얼을 봅니다."
ALLY_FLAG1_ID	이것이 당신의 색깔입니다.
ALLY_FLAG2_ID	이 색깔은 당신의 동맹국입니다.
ALLY_FLAG3_ID	이 색깔은 당신의 동맹국입니다.
ALLY_FLAG4_ID	이 색깔은 당신의 동맹국입니다.
ALLY_FLAG5_ID	이 색깔은 당신의 동맹국입니다.
ALLY_FLAG6_ID	이 색깔은 당신의 동맹국입니다.
ALLY_FLAG7_ID	이 색깔은 당신의 동맹국입니다.
ALLY_FLAG8_ID	이 색깔은 당신의 동맹국입니다.
ENEMY_FLAG1_ID	이 색깔은 당신의 적국입니다.
ENEMY_FLAG2_ID	이 색깔은 당신의 적국입니다.
ENEMY_FLAG3_ID	이 색깔은 당신의 적국입니다.
ENEMY_FLAG4_ID	이 색깔은 당신의 적국입니다.
ENEMY_FLAG5_ID	이 색깔은 당신의 적국입니다.
ENEMY_FLAG6_ID	이 색깔은 당신의 적국입니다.
ENEMY_FLAG7_ID	이 색깔은 당신의 적국입니다.
ENEMY_FLAG8_ID	이 색깔은 당신의 적국입니다.
WHICHMAP_ID	이것이 당신이 플레이 하려는 지도의 크기입니다.
MAP_AREA_1	MAP_AREA_1
MAP_AREA_2	MAP_AREA_2
MAP_AREA_3	MAP_AREA_3
MAP_AREA_4	MAP_AREA_4
MAP_AREA_5	MAP_AREA_5
MAP_AREA_6	MAP_AREA_6
MAP_AREA_7	MAP_AREA_7
MAP_AREA_8	MAP_AREA_8
MAP_AREA_9	MAP_AREA_9
MAP_AREA_10	MAP_AREA_10
MAP_AREA_11	MAP_AREA_11
MAP_AREA_12	MAP_AREA_12
MAP_AREA_13	MAP_AREA_13
MAP_AREA_14	MAP_AREA_14
MAP_AREA_15	MAP_AREA_15
MAP_AREA_16	MAP_AREA_16
MAP_AREA_17	MAP_AREA_17
MAP_AREA_18	MAP_AREA_18
MAP_AREA_19	MAP_AREA_19
MAP_AREA_20	MAP_AREA_20																						
MAP_AREA_21	MAP_AREA_21																						
MAP_AREA_22	MAP_AREA_22																						
MAP_AREA_23	MAP_AREA_23																						
MAP_AREA_24	MAP_AREA_24																						
MAP_AREA_25	MAP_AREA_25																						
MAP_AREA_26	MAP_AREA_26																						
MAP_AREA_27	MAP_AREA_27																						
MAP_AREA_28	MAP_AREA_28																						
MAP_AREA_29	MAP_AREA_29																						
MAP_AREA_30	MAP_AREA_30																						
MAP_AREA_31	MAP_AREA_31																						
MAP_AREA_32	MAP_AREA_32																						
																							
CampaignWindow	CampaignWindow																						
																							
여왕폐하 만세	여왕폐하 만세		
해방	해방		
전리품	전리품		
아버지를 위한 노래	아버지를 위한 노래		
던젼과 악마들	던젼과 악마들		
국왕폐하 만세	국왕폐하 만세		
불만의 씨앗	불만의 씨앗		
아마겟돈즈 블레이드	아마겟돈즈 블레이드		
드래곤의 피	드래곤의 피		
드래곤 슬레이어	드래곤 슬레이어		
생명의 축제	생명의 축제		
무모한 고집	무모한 고집		
불의 유희	불의 유희		
학살	학살		
바바리안의 탄생	바바리안의 탄생		
새로운 시작	새로운 시작		
엘릭서 오브 라이프	엘릭서 오브 라이프																						
네크로맨서의 부흥	네크로맨서의 부흥																						
저주받은 동맹	저주받은 동맹																						
사악한 유령	사악한 유령																						
																							
																							
ROLLOVER	ROLLOVER																						
																							
Recruit	Recruit																						
최대																							
고용																							
취소																							
																							
Multiplayer	Multiplayer																						
확인 박스	이름을 작동/중지시키려면 여기에 클릭하세요.																						
플레이어 이름 입력	플레이어 이름 입력																						
승인																							
뒤로																							
게임명 입력																							
패스워드 입력																							
게임명																							
IP 주소 입력																							
																							
Sacrifice Window	Sacrifice Window																						
나가기(아무것도 희생시키지 않음).	제단을 떠납니다.  제단위에 올려놓았던 모든 것들은 다시 당신이 소지합니다.																						
현재 올려진 물체																							
소지한 모든 물체를 제단에 올림	당신의 영웅이 사물함에 소지하고 있는 아티팩트를 제단에 올려놓습니다.																						
모든 물체를 제단에 올림	당신의 영웅이 소지한 아티팩트와 현재 장비하고 있는 모든 아티팩트들을 제단에 올려놓습니다.																						
유닛 희생	유닛들을 희생시켜 경험치를 얻습니다.  단 영웅의 속성이 악하거나 중립적일 경우만 가능합니다.																						
유닛 숫자 / 경험치																							
현재 선택된 유닛																							
괴물 유닛 / 경험치																							
희생될 유닛 숫자																							
희생될 유닛 숫자 지정																							
희생될 유닛 숫자 최대로 지정	제단위에 최대한 많은 유닛들을 올려놓습니다.																						
영웅의 부대내에 모든 유닛을 희생	1마리만 남겨두고 모든 유닛들을 제단에 올려놓습니다.																						
아티팩트 희생	아티팩트를 희생시켜 경험치를 얻습니다.  단 영웅의 속성이 선하거나 중립적일 경우만 가능합니다.																						
유닛 숫자 / 경험치																							
희생할 아티팩트를 이곳에 올려놓으세요.																							
유닛의 경험치																							
제단에 올려진 아티팩트 희생	제단에 올려진 아티팩트를 희생시키고 그만큼의 경험치를 얻습니다.																						
제단에 올려진 유닛 희생	제단에 올려진 아티팩트를 희생시키고 그만큼의 경험치를 얻습니다.																						
	사물함 살펴보기																						
	사물함 살펴보기																						
																							
Skeleton Transformer	Skeleton Transformer																						
모든 유닛들을 해골 변환기에 놓습니다.	모든 유닛들을 해골 변환기에 놓습니다.																						
변환기에 들어간 유닛들을 해골 병사로 전환합니다.	전환기에 들어간 유닛들을 해골 병사로 전환합니다.																						
변환기를 나갑니다.	변환기를 나갑니다. 더 이상 언데드로 변환할 유닛이 없습니다.																						
																							
Trade Window	Trade Window																						
교역																							
최대량																							
다른 플레이어에게 자원 건네주기																							
물체 구입																							
유닛 팔기																							
나가기																							
																							
Give Resource Window	Give Resource Window																						
교역																							
최대량																							
자원 교역																							
물체 구입																							
나가기																							
																							
Buy Artifact Window	Buy Artifact Window																						
교역																							
자원 교역																							
다른 플레이어에게 자원 건네주기																							
아티팩트 팔기																							
나가기																							
																							
Sell Artifact Window	Sell Artifact Window																						
교역																							
자원 교역																							
다른 플레이어에게 자원 건네주기																							
아티팩트 구입																							
나가기																							
																							
Sell Creature Window	Sell Creature Window																						
교역																							
최대량																							
자원 교역																							
다른 플레이어에게 자원 건네주기																							
나가기																							
																							
University Window	University Window																						
취소	기술수준 선택으로 복귀																						
나가기	대학 떠나기																						
	%s %s을(를) %d 금의 수업료를 지불하고 배우기																						
Not used...  filthy bug.																							
Insert all data before this line. Do not alter or delete this line.																							



																							
